07
25
#######>########???####??
#.....m.m......#???#..#??
#.B...m*m......#####..###
#*@>..mmm....../........#
#.$.m.......$..#####....#
#..B...........#???#....#
################???######
10
