07
25
#######>########???####??
#.....m.m......#???#..#??
#.B...m*m......#####..###
#.@...mmm....../........#
#.B.m.......$..#####....#
#..B...........#???#....#
################???######
10
