07
25
#######>########???####??
#.....m.m......#???#..#??
#.m...m*m......#####..###
#.@B..mmm....../........#
#./.m.......$..#####....#
#..B...........#???#....#
################???######
10
